###################
#....#.......#....#
#O##.#.#####.#.##O#
#.................#
##.#.###.#.###.#.##
##.#.###.#.###.#.##
--.#.....#.....#.--
##.### ##### ###.##
##.-------------.##
##.###-##&##-###.##
##.#---#FFF#---#.##
##.#-#-#####-#-#.##
--.--#-------#--.--
##.#####-#-#####.##
##.....--#--.....##
##.###.#####.###.##
#........P........#
#.##.###.#.###.##.#
#.##.#...#...#.##.#
#O##.#.#####.#.##O#
#.................#
###################