######-------######
#....#-------#..O.#
#..#.#########.#..#
#..#...........#..#
#O.#...#####...#..#
####...#####...####
---#...........#---
---###.#####.###---
-----#.#---#.#-----
-----#O#---#O#-----
-----#.#---#.#-----
-----#.#####.#-----
-----#.......#-----
-----###.#.###-----
-------#.#.#-------
---#####.#.#####---
---#.....P.....#---
####...#####...####
#......#.O.#...&-F#
#..#...##.##...#-F#
#O.#...........#-F#
###################